++++--+--+--+--+
|  |           *
|  |++|  |+++  +
|  |  |  |  |  +
|  |  |  |  |  +
+           |  +
+--+**+--+--+  +
g              *  
+--*--*--*--*--+