+--+--+--+--+--+
|           *  *
+  +  +--+  +  +
|  *     *     |
+  +--+  +--+  +
|     *     |  |
+--+  +--+  +  +
|              g  
+--+--+--+--+--+