+--+--+--+--+--+
|              |
+--+**+  +  +  +
|              |
+  +--+  +  +  +
|     |        |
+**+  +--+--+--+
|              g  
+--+||+**+||+--+