+--+--+--+--+--+
|           *  *
+  +--+--+  +  +
|  |     |     *
+  +--+  +--+  +
|     |     |  *
+--+  +--+  +  +
|              *  
+--+--+--+--+--+