++++--+--+--+--+
|  |           -
|  |++|  |+++  +
|  |  |  |  |  +
|  |  |  |  |  +
+           |  +
+**+--+--+--+  +
g              -  
+--------------+